あい	慈愛	名詞
あいて	対戦者	名詞
あいてむ	匕首	名詞
あくしょん	行動	名詞
あし	足刀	名詞
あす	未来	名詞
あすりーと	運動家	名詞
あたる	命中る	名詞
あっぷ	上昇	名詞
あなこんだ	大蛇	名詞
あまちゅあ	喧嘩	名詞
あんなちゅらる	不自然	名詞
あんふぇあ	不公平	名詞
いた	存在	名詞
いたみ	激痛	名詞
いま	現在	名詞
いめーじ	印象	名詞
いんたーばる	休憩	名詞
うぇいと	体重	名詞
うぉーず	戦争	名詞
うぉーむあっぷ	準備運動	名詞
うけ	防御	名詞
うける	防御る	名詞
うごく	行動く	名詞
えきすぱーと	専門家	名詞
えごいずむ	自我	名詞
えくすぷろしぶ	爆薬	名詞
えもの	武器	名詞
えらぶ	選択ぶ	名詞
えんどるふぃん	脳内麻薬	名詞
おいる	油	名詞
おお	雄鳴	名詞
おーが	鬼	名詞
おーぷにんぐ	幕開け	名詞
おしらせ	お報らせ	名詞
おそれる	恐怖れる	名詞
おそれる	畏怖れる	名詞
おとこ	男性	名詞
おとこ	雄	名詞
おとこ	闘技者	名詞
おとこ	?客	名詞
おとこ	男子	名詞
おどろく	驚愕ろく	名詞
おのれ	自己	名詞
おのれ	自分	名詞
おもさ	重量さ	名詞
おもさ	重量感	名詞
おやじ	師匠	名詞
おりじなる	個性	名詞
おりる	降下る	名詞
おわる	終了る	名詞
おわる	結着る	名詞
おわらせる	結着らせる	名詞
おわらせる	終了らせる	名詞
おんな	女性	名詞
おんな	雌	名詞
かーど	対戦	名詞
かえる	変化る	名詞
かお	顔面	名詞
かお	表情	名詞
かおり	芳香り	名詞
がき	子供	名詞
がき	少年	名詞
がきども	不良供	名詞
がきども	少年供	名詞
かず	体験	名詞
かち	勝利	名詞
かわる	変化る	名詞
がんだむ	厳駄無	名詞
きまる	完全る	名詞
きまる	決定る	名詞
きめる	決定る	名詞
きまる	決着る	名詞
きめる	冷静る	名詞
きゃっしゅ	現金	名詞
きゃぷてん	主将	名詞
ぎゃらりー	見物人	名詞
きらー	殺し屋	名詞
くらしっく	正統派	名詞
ぐらっぷらー	格闘士	名詞
ぐらっぷらー	格闘家	名詞
ぐらっぷる	格闘	名詞
くらんけ	患者	名詞
くるま	高級車	名詞
くろー	握撃	名詞
けり	結着	名詞
けり	決着	名詞
けんか	格闘	名詞
けんか	街頭	名詞
けんか	勝負	名詞
けんか	八九三	名詞
けんか	実戦	名詞
けんか	格闘技	名詞
こ	少年	名詞
こいつら	肉体	名詞
こえる	超越る	名詞
ここらへん	ここら地方	名詞
こたえる	反応る	名詞
ごろ	喧嘩	名詞
ころし	殺人	名詞
ころす	殺人す	名詞
ごろめんつ	喧嘩意地	名詞
こわい	恐怖い	名詞
こわさ	恐怖さ	名詞
こわれる	破壊れる	名詞
こんでぃしょん	状態	名詞
こんでぃしょん	体調	名詞
さー	大将	名詞
さいん	苦痛	名詞
さき	先手	名詞
さでぃすてぃっく	変質的攻撃癖	名詞
さぶみっしょん	関節技	名詞
しあわせ	幸福	名詞
しあわせもの	幸福者	名詞
じぇらしー	嫉妬	名詞
じか	直接	名詞
した	地面	名詞
した	部下	名詞
した	下界	名詞
しぼむ	縮小む	名詞
じゃり	小僧	名詞
じゅにあ	夜叉猿Jr	名詞
じょいんと	関節	名詞
じょー	顎	名詞
しょっく	衝撃	名詞
しらべる	調査べる	名詞
すたいる	構え	名詞
すたみな	持久力	名詞
すていたす	栄誉	名詞
すてごろ	素手喧嘩	名詞
すてろいど	薬物	名詞
すとまっく	胃	名詞
すとりーとふぁいたー	喧嘩屋	名詞
すとりーとふぁいと	喧嘩	名詞
すとろんぐすたいる	正統派	名詞
すぷりんたー	短距離走者	名詞
すぺしゃるまっち	異種格闘技戦	名詞
すぺしゃるまっち	特別試合	名詞
すぽーつ	競技	名詞
せがれ	息子	名詞
せみふぁいなる	準決勝	名詞
せれくと	選択	名詞
せんせい	師匠	名詞
そーりー	失礼	名詞
ぞく	暴走族	名詞
たーげっと	標的	名詞
たいまん	一対一	名詞
だうん	倒れ	名詞
だす	出場す	名詞
たたかい	武闘	名詞
たたかい	闘争い	名詞
たたかう	戦闘う	名詞
だち	親友	名詞
たのしむ	愉悦しむ	名詞
たのむ	依頼む	名詞
たふ	頑丈	名詞
たふねす	打たれ強さ	名詞
たふねす	耐久力	名詞
たま	命	名詞
たま	弾丸	名詞
ため	互角	名詞
ためはる	互角張る	名詞
たんく	戦車	名詞
ちーむ	合体	名詞
ちかく	付近	名詞
ちかづく	接近づく	名詞
ちがう	変化う	名詞
ちから	実力	名詞
ちから	本領	名詞
ちから	暴力	名詞
ちから	能力	名詞
ちから	威力	名詞
ちゃいにーず	中国人	名詞
ちゃか	拳銃	名詞
ちゃんす	機会	名詞
ちゃんぴおん	王者	名詞
ちゃんぴおん	王座	名詞
ちゅうぼう	中学生	名詞
ちょうめじゃー	超有名	名詞
ちょーく	裸絞め	名詞
つく	到着く	名詞
つかう	使用う	名詞
つく	付着く	名詞
つくる	育る	名詞
つくる	製造る	名詞
つぐ	継続ぐ	名詞
つづける	継続ける	名詞
つづける	続行ける	名詞
つぶす	壊滅す	名詞
つれる	連行る	名詞
でかい	雄大い	名詞
てき	相手	名詞
てくにかる	技術的	名詞
てくにっく	技術	名詞
てすと	実験	名詞
でる	出場る	名詞
でてくる	出場くる	名詞
てりとりー	領域	名詞
でんわ	ＴＥＬ	名詞
とーたるふぁいたー	総合格闘家	名詞
とき	瞬間	名詞
どくたー	医者	名詞
どくたー	医師	名詞
ところ	場所	名詞
とし	年齢	名詞
とっぷしーくれっと	最高機密	名詞
とめる	停止る	名詞
どらごん	龍	名詞
とる	殺る	名詞
とれーなー	師匠	名詞
どん	首領	名詞
ないと	騎士	名詞
なか	中央	名詞
なみ	普通	名詞
なり	服装	名詞
にく	筋肉	名詞
にげる	逃走る	名詞
ぬける	脱出る	名詞
めねつける	睨めつける	名詞
のぞむ	願望む	名詞
のぞむ	飢望む	名詞
のれる	逃れる	名詞
はーと	心	名詞
はいる	侵入る	名詞
はいる	入場る	名詞
ばいてぃんぐ	噛みつき	名詞
はええ	迅ええ	名詞
はええ	疾ええ	名詞
ぱくる	真似る	名詞
ばける	変化る	名詞
はしる	奔る	名詞
はじまる	開始まる	名詞
はじめる	開始める	名詞
はじめ	最初	名詞
ばとる	闘	名詞
ばとる	闘い	名詞
ばとる	対決	名詞
はな	最初	名詞
ぱにっくじょうたい	恐慌状態	名詞
ぱぱ	父	名詞
はやい	迅い	名詞
はやさ	迅さ	名詞
はやさ	迅度	名詞
はら	胆	名詞
ぱわー	瞬発力	名詞
ぱわー	腕力	名詞
ぱわー	脚力	名詞
はんたー	狩人	名詞
はんぱ	生半可	名詞
ひーと	白熱	名詞
ひーる	悪役	名詞
びっくかーど	大一番	名詞
ひってぃんぐまっする	打撃用筋肉	名詞
ひと	人間	名詞
ひと	人類	名詞
ひま	瞬間	名詞
ひも	神経	名詞
ぴんち	窮地	名詞
ふぁーすとこんたくと	最初の出会い	名詞
ふぁいたー	闘技者	名詞
ふぁいてぃんぐきっず	ケンカ小僧	名詞
ふぁいてぃんぐぽーず	構え	名詞
ふぁいと	格闘	名詞
ふぁいと	闘い	名詞
ふぁいなる	最終試合	名詞
ふぁいなる	決勝	名詞
ふぁっと	脂肪	名詞
ふぇいんと	眩惑	名詞
ふぇいんと	牽制	名詞
ふせぐ	防御ぐ	名詞
ふたり	両者	名詞
ぶらじる	移民先	名詞
ふるえる	畏怖える	名詞
ぷれじでんと	大統領	名詞
ぷろ	兵隊	名詞
ぶろー	拳	名詞
ぷろせす	人生	名詞
ぷろぼくさー	職業拳闘士	名詞
べあなっくるあーみー	素手の軍隊	名詞
べすと	完全	名詞
ほう	法律	名詞
ぼうや	刃牙	名詞
ぼうや	一年生	名詞
ぼーいすかうと	自衛官	名詞
ぼでぃ	中段	名詞
ぼでぃ	身体	名詞
ぼでぃがーど	護衛	名詞
ぼでぃぶろー	中段突き	名詞
ぼにーた	美女	名詞
ほんちゃん	本気	名詞
ほんちゃん	本物	名詞
まーしゃるあーつ	武術	名詞
まえ	過去	名詞
まえ	以前	名詞
まえ	直前	名詞
まぐれ	例外	名詞
まける	敗北る	名詞
ますたー	修得	名詞
まっくす	全力	名詞
まっする	筋肉	名詞
まとも	健康	名詞
まもり	護身り	名詞
まもる	護身る	名詞
まりーん	海兵隊	名詞
みがく	研鑽く	名詞
みす	失敗	名詞
みる	見学る	名詞
みんち	挽き肉	名詞
めざめる	覚醒める	名詞
めん	形相	名詞
もどる	復帰る	名詞
もののふ	武道家	名詞
もめる	抗争る	名詞
もろてぬき	両手貫き	名詞
もんすたー	怪物	名詞
もんもん	彫り物	名詞
やる	闘る	名詞
やる	潰る	名詞
やる	飲る	名詞
やぶる	突破る	名詞
やぶれる	敗北れる	名詞
やま	山野	名詞
やりかた	方法	名詞
やる	戦闘る	名詞
やる	演る	名詞
よそ	他校	名詞
よろこび	生き甲斐	名詞
よろこぶ	喜悦び	名詞
らいおん	獅子	名詞
らいばる	敵	名詞
らっしゅ	回転力	名詞
りあるふぁいと	真剣勝負	名詞
りーさるうえぽん	最終兵器	名詞
りーべん	日本国	名詞
りざーばー	補欠選手	名詞
りずむ	秩序	名詞
れくちゃー	講義	名詞
ればー	肝臓	名詞
ろーぷすきっぴんぐ	縄跳び	名詞
わかる	理解る	名詞
わけ	理由	名詞
わざ	技術	名詞
わざ	技法	名詞
わらう	嘲笑う	名詞
わらう	微笑う	名詞
わんみにっと	一分	名詞
